# Austria
AUT = "countries/Austria2.txt"

# Bavaria
BMU = "countries/BavariaMunich.txt"
BIN = "countries/BavariaIngolstadt.txt"
BLH = "countries/BavariaLandshut.txt"
BAS = "countries/BavariaStraubing.txt"
REG = "countries/Regensburg.txt"
BMB = "countries/Bamberg.txt"

# Switzerland
THL = "countries/ThreeLeagues.txt"

# Silesia
BRL = "countries/Breslau.txt"
GLG = "countries/Glogau.txt"
LGN = "countries/Legnica.txt"
RTB = "countries/Raciborz.txt"

# Westphalia
OSN = "countries/Osnabruck.txt"
HOY = "countries/Hoya.txt"
CLB = "countries/Calenberg.txt"
PDB = "countries/Paderborn.txt"

# Balkans
HUM = "countries/Hum.txt"

# Italy
ANC = "countries/Ancona.txt"
RMG = "countries/Romagna.txt"

# France
ANG = "countries/Angoumois.txt"
MTZ = "countries/Metz.txt"

# Pomerania
STP = "countries/Stolp.txt"
WLG = "countries/Wolgast.txt"
STT = "countries/Stettin.txt"